##########
#........#
#.#..#.#.#
#.#..#.#.#
####..####
#.#...#..#
#.#...#..#
#.#...##.#
#........#
##########