##########
#.....#..#
#.#...##.#
#.#...##.#
####..####
#.#...#..#
#.#...#..#
#.#...##.#
#........#
##########